XXXXXXX2222XXXXXXX
X              H0X
X                X
X          L     X
X    U           X
X                X
X    XX   XH1    X
X     X XX       X
X    SXX         X
X     X XX H2    X
X    XX   X      X
X                X
X    D           X
X     B2         X
X         R      X
X              H0X
X                X
XXXXXXX1111XXXXXXX
